AH=安徽
BJ=北京
FJ=福建
GS=甘肃
GD=广东
GX=广西
GZ=贵州
HI=海南
HE=河北
HA=河南
HB=湖北
HN=湖南
JL=吉林
JS=江苏
JX=江西
LN=辽宁
NX=宁夏
QH=青海
SD=山东
SX=山西
SN=陕西
SH=上海
SC=四川
TJ=天津
XZ=西藏
XJ=新疆
YN=云南
ZJ=浙江
CQ=重庆
NM=内蒙古
HL=黑龙江